20 20 
####################
#..................#
#######...e....#...#
#.....#........#...#
#..@..#........#####
#.....#........#...#
#..####.....e..#...#
#..............#...#
#..................#
####################