20 20 
####################
#..................#
#######........#...#
#.....#........#...#
#.....#........#####
#.....#...@....#...#
#..####........#...#
#..............#...#
#..................#
####################