30 30 
##############################
###.........d........#########
###........###.......#########
###...e....###.......#########
###........###.......#########
###........###.......#########
###........###...............#
##############...............#
##############........e......#
#............................#
#............................#
#............................#
#.......######################
#.......######################
#......................#######
#......................#######
#......................#######
#...........@..........#######
#......................#######
#......e...............#######
#......................#######
#......................#######
#########.....################
#########.....################
#########.....##.............#
#########.....##.............#
#########.....##......e......#
##............d..............#
##............##.............#
##############################